https://urldefense.com/v3/__https://puzzle-english.com/directory/1000-popular-words__;!!GF_29dbcQIUBPA!kGkycwXjKqloAKdFSL5h01X8c-V587vWuyusJYReLTflVeo0YsZPx7JGJ6_M0LXaMS2UDg$ [puzzle-english[.]com]
sentence [  ] — предложение
cause [ ] — причина
through [  ] — через
then [  ] — затем
cover - покрытие\крышка
cross - пересекать\крест
carry - нести
got - получать(прош вр)
ease - легкость
those - те
above - над
plain - простой
plane - самолет\плоскость
ever - когда либо
though - хотя однако
direct - прямой\направлять
measure - мера\ измерять
inch - дюйм
surface - поверхность
wish - желать
stead - место
dry - сухой
wonder - чудо\ удивляться
laungh - смех
ran - прош от run - 
shape - форма
equate - приравнивать
brought - привел
heat - жара
tire - шина\утомлять
distant - отдаленный
paint - краска
unit - еденица
certain - определенный
noun - существительное
rest - остальное\отдыхать
pound - фунт
stood -stand- стоял
gave - give
tail - хвост
produce - производить
heard - слышал
hundred - 100
vowel - гласный(звук)
lay -lie- рельеф\ лежать
lie - ложь
appear - появиться
govern - управлять
notice - уведомление/ замечать
probable - вероятный
ride - ездить
pick - выбирать
sudden - внезапный
vary - меняться(варьироваться)
settle - селиться
matter - иметь значение \ предмет \ материя
pair - пара
divide - разделять
syllable - слог
felt - чувствовал
grand - большой \ великий
engine - двигатель
wide - широкий \ повсюду
sail - паруса \ плавать
fraction - доля
prove - доказывать
exercise - упражнение
mount - взбираться \ монтировать \ гора?
wish - желать
joy - радость
kept -keep- сохранил
edge - край
soft - мягкий
bright - яркий
strange - странный
gone - ушедший
trip - поездка
receive - получать
exact - точный
600
least - наименее
suffer - страдать
shout - кричать
except - кроме \ исключая
suggest - предлагать
yard - двор
goal - цель
brown - коричневый
wear - носить
sent - отправил
fit - соответствовать \ подходить
flow - поток \ течь
fair - ярмарка \ честный
ear - ухо
quite - довольно
case - случай
scale - шкала \ зависеть?
loud - громко
straight - прямо
665
consonant - согласный (звук)
cloud - облако
quiet - тихо \ тихий
tiny - крошечный
vibe - атмосфера
poor - бедный
explain - объяснять
flat - квартира \ плоский
crease - складка \ мять
stick - придерживаться\ приклеивать
meet - встречать
whether - будь то \ ли
shall - должен
held -hold- держал
either - либо \ или
hill - холм
century - век
bit - часть
coast - берег
phrase - фраза\ формулировать
tall - высокий
soil - почва
beat - бить\ритм
excite - возбуждать
sense - смысл \ чувство
capital - столица
//wont - не будет
thick - толстый
difficult - сложный
noon - полдень
crop - обрезать \ урожай
modern - современный
corner - угол
supply - поставка \ снабжать
whose - чьи
insect - насекомое
caught - поймал \ мойманный
indicate - указывать
spoke - говорил
expect - ожидать
rail - рельс
imagine - представлять
thus - таким образом
gentle - нежный
guess - предположение \ угадывать
sharp - острый \ умный
wash - мыть
bat - летучая мышь
rather - скорее
810
crowd - толпа
corn - кукуруза
bell - колокол
rub - тереть
tube - трубка
famous - известный
sight - взгляд \ вид
thin - тонкий
hurry - торопиться
colony - колония
tie - галстук
allow - позволять
arrive - прибывать \ приехать
shore - побережье
division - деление \ отдел
sheet - лист \ простынь
substance - вещество
favour - одолжение
forget - забыть
post - почта \ после
glad- рад
proper - правильный
degree - степень(магистратура)
populate - населять
dear - дорогая
reply - ответ
occur - происходить
steam - пар
liquid - жидкость
violence - жестокость
meant - mean - значил
quotient - частное
shell - ракушка
neck - шея
magnet - магнит
treat - угощать
especially - особенно
afraid - испуганный
huge - огромный
similar - похожий
923
evidence - доказательства
band - группа
rope - веревка
slip - скользить
smell - запах
valley - долина
particular - особый\частный(случай)
deal - сделка \ часть
term - срок \ семестр \ термин
opposite - напротив
shoulders - плечи
spread - распространение
arrange - устроить \ договориться
invent - изобретать
cotton - хлопок
quarter - четверть
noise - шум
gather - собирать
stretch - растягивать
shine - сиять
property - свойство \ собственность
986
broad - широкий
nose - нос
plural - множественное число
anger - гнев
claim - запрос \ требовать
price - цена
eventually - в итоге
recipient - получатель
instead - вместо
Producing - производство
producer - производитель
consumer - потребитель
flow -поток \ течь
bound - связанный \ направляющий
essentially - по существу \ существенным образом
receive - получить
meaning  - значит \ смысл
similar  - копия \ подобный
reside - проживать \ находиться
indeed - на самом деле
gloss - упустить \ блеск
below - ниже
distribute - распространять
assumes  - предполагать
care - забота
negotiation - переговоры
hence  - следовательно
scratching  - царапины
therefore  - следовательно
refusing - отказ
Since  - поскольку
intentionally  - намеренно
sake of brevity - краткость
immediately  - немедленно
schedule  - график \ расписание
stand  - стоять
pretending  - притворяться
complexity - сложность
slightly - слегка
arbitrary  - произвольный
Persistent  - стойкий
perform  - выполнять
Once - однажды
dispatched - отправлен
particular  - особый
soon - скоро
Attempts  - попытка
Forgotten  - забытый
forget - забыть
Fair -честно \ справедливо
Dispatch - отправка
odd  - странный
evenly - равномерно
blind - слепой
sample - образец
As far as I have been able to figure out - насколько я смог выяснить
regards - с уважением
either  - либо \ или \ любой
hesitate - колебаться \ стесняться
apparent - очевидно
obviously - очевидно \ явно
hard luck - невезение
whereby  - согласно которому
sensitive - чувствительный
stock  - склад \ запас
persistent - стойкий
nature - природа
eagle -орел
eyed - взгляд
amongst -среди
almost  - почти
hugely  - чрезвычайно
caveat  - предостережение
Confluent - сливаться
compatible - совместимый
Unless  - если только
mandatory - обязательный
specifies - указывает
retrieve  - получить
ensure  - обеспечивать \ гарантировать
partitions  - раздел
introduce - вводить
whilst - пока \ в то время
Suggest - предлагать
derives - происходит
peer - всматриваться
valuable - ценный
judgment - суждение
complicated - сложный
familiar - знакомые \ привычные
stale - несвежий
