earth - земля
cigarette - сигарета
promise - обещание
apologise - принести извинения
advise - консультировать
insist - настаивать
refuse - отказаться
accident - несчастный случай
tell - сказать
rise - подъем повышать
liar - лжец
formally - формально
circa - около приблизительно
mainstay - опора
mention - упоминание
twofold - двоякий
fold - складывать
equally - одинаково
numerous - многочисленные
journey - поездка \ путешествие
groundwork - фундамент
ground - земля
remainder - остаток
chapter - глава
survey - опрос
overview - обзор
independent - независимый
explore - исследовать
frequently - часто
forbidden - запрещенный
diverse - разнообразный
plagued - измеченный
fragile - хрупкий
Despite - несмотря на
countless - бесчисленное множество
nowadays - настоящее время
positive sentence - повествовательное
take place - проходить
have a rest - отдыхать
chill - отдыхать где то, бар и тд
wake up\ get up - проснуться
adjective - прилагательное
auxiliary -вспомогательный
adverb - наречие
tenses - время
going to visit - планы которые точно случатся
come up with - придумать
destination - пункт назначения
instead - вместо
advice - совет
meaning - смысл
Conceivable - возможный
Despair - отчаяние
lack - отсутсвие \ недостаток
belong - принадлежать
beyond - за пределами
be obsessed with - быть озабоченным чем-то - одержима
seek - стремиться \ искать
sick - больной
illnesses - болезнь
fulfilling - наполняющий
studie - изучение
Resilient - жизнерадостный
belonging - принадлежать
value - ценить может быть значение
as well - обратно \ также
purpose - цель
Custodian - попечитель
narrative - рассказ
clarity - ясность
to hold on to - держаться за
friendship - дружба
frequency - частота - дважды в неделю
pillar -столб
Renowned - признанный
Resilient - жизнерадостный
Intrinsically - в действительности
Custodian - попечитель







65-4






